
F	しょ
J	しゅ
D	きょ
K	じょ
E	りょ
I	しゃ
W	じゅ
O	ちょ
A	きゅ
C	ちゅ
<	ひょ
X	ぎょ
>	ちゃ
V	にゅ
M	じゃ
Z	てぃ
R	でぃ
U	びょ
Q	りゅ
P	ふぁ
G	みゅ
H	きゃ
B	じぇ
N	ふぉ
T	びゃ
Y	みょ
Sf	ぎゃ
Lf	ふぃ
Sj	りゃ
Lj	ちぇ
Sd	ぴょ
Ld	ぎゅ
Sk	ふぇ
Lk	ひゃ
Se	びゅ
Le	でゅ
Si	うぃ
Li	うぇ
Sw	うぉ
Lw	にょ
