F	しょ
J	しゅ
D	きょ
K	じょ
E	りょ
I	しゃ
W	じゅ
O	ちょ
A	きゅ
C	ちゅ
<	ひょ
X	ぎょ
>	ちゃ
V	にゅ
M	じゃ
Z	てぃ
R	でぃ
U	びょ
Q	りゅ
P	ふぁ
G	みゅ
H	きゃ
B	じぇ
N	ふぉ
T	びゃ
Y	みょ
LF	ぎゃ
SJ	ふぃ
LD	りゃ
SK	ちぇ
LS	ぎゅ
SL	ぎゅ
LA	ぴょ
SI	ふぇ
LE	ひゃ
SO	びゅ
LW	でゅ
S<	うぃ
LC	うぇ
S>	うぉ
LX	にょ
SM	ぴゃ
LV	ぴゅ
SU	にぁ
LR	しぇ