Q	みょ
W	ぎょ
E	ちゅ
R	ふぉ
T	ちぇ
Y	りゃ
U	じぇ
I	きゅ
O	ひょ
P	びゃ
!	にゃ
?	ぴゅ
A	ちょ
S	しゃ
D	じょ
F	しゅ
G	きゃ
H	みゅ
J	しょ
K	きょ
L	りょ
&	じゅ
Z	ふぁ
X	びょ
C	てぃ

V	にゅ
B	ふぃ
N	ぎゃ
M	ちゃ
<	じゃ
>	でぃ
|	りゅ


%	ぎゅ
)	うぃ
$	びゅ
}	うぉ
~	ひゃ
]	ふぇ
^	みゃ
`	でゅ